8 8
4 4
4
1 4 4 6 3 1 6 3
4 4 3 3 3 4 4 4
4 4 3 0 3 4 4 4
4 4 3 0 3 3 3 3
3 3 3 2 0 2 0 3
3 0 0 2 1 3 3 3
3 3 3 3 2 3 4 4
4 4 4 3 0 3 4 4
4 4 4 3 3 3 4 4
