8 8
2 1
3
1 4 1 5 1 6
4 3 3 3 3 3 4 4
4 3 1 0 3 3 3 4
4 3 0 2 0 0 3 4
3 3 3 0 3 0 3 3
3 0 3 0 3 0 0 3
3 0 2 0 0 3 0 3
3 0 0 0 0 2 0 3
3 3 3 3 3 3 3 3

