11 7
2 3
4
2 4 2 5 3 4 3 5
4 3 3 3 3 3 3 3 3 4 4
4 3 0 0 0 0 0 0 3 3 3
3 3 2 3 3 3 3 0 0 0 3
3 0 1 0 2 0 0 0 2 0 3
3 0 0 0 3 0 0 2 0 3 3
3 3 0 0 3 0 0 0 0 3 4
4 3 3 3 3 3 3 3 3 3 4