13 11
11 8
5
4 2 2 6 6 8 8 4 5 5
4 4 4 3 3 3 3 3 3 3 4 4 4
3 3 3 3 0 0 0 0 0 3 4 4 4
3 0 0 0 0 3 3 3 0 3 4 4 4
3 0 3 0 3 0 0 0 0 3 3 4 4
3 0 3 0 2 0 2 3 0 0 3 4 4
3 0 3 0 0 2 0 0 3 0 3 4 4
3 0 0 3 2 0 2 0 3 0 3 4 4
3 3 0 0 0 0 3 0 3 0 3 3 3
4 3 0 3 3 3 0 0 0 0 0 1 3
4 3 0 0 0 0 0 3 3 0 0 0 3
4 3 3 3 3 3 3 3 3 3 3 3 3 